1111111111111111111111111111111111111111111111111111111111111111111111111111111111
1001000000000000000000000000000000000000000000000C000000000000000000000000000CCCC1
1000011111000000000000000000000000000000000000000C000000000000000000000000000CCCC1
1P0011E000000000000000000C00000000000000000000000C000000000000000000000000000CCCC1
1111111111111111111111111111111111111111111111111111111111111111111111111111111111
