111111111111
1E0000000001
101001010011
101001001011
100000000C01
100000000C01
100000000C01
100000000C01
100000000C01
100000000C01
100000000C01
100000000C01
100000000C01
100000000C01
100000000C01
100000000C01
100000000C01
100000000C01
100000000C01
100000000C01
100000000C01
100000000C01
100000000C01
100000000C01
100000000C01
100000000C01
100000000C01
100000000C01
100000000C01
100000000C01
100000000C01
100000000C01
100000000C01
100000000C01
100000000C01
100000000C01
100000000C01
100000000C01
100000000C01
100000000C01
100000000C01
100000000C01
100000000C01
100000000C01
100000000C01
100000000C01
100000000C01
100000000CP1
111111111111
