111111111111111111111111
100000000001111100000001
1000000000100CP010000001
1000000000100E0010000001
100000000010000010000001
100000000010000010000001
100000011110000011110001
100000100001000100001001
100000011110000011110001
111111111111111111111111